Những	L
ngày	N
đẹp_đẽ	A
ấy	P
,	CH
bố	N
luôn	R
dành	V
thời_gian	N
để	E
vui_vẻ	A
với	E
anh_em	N
tôi	P
.	CH

Trong	E
khi	N
chờ	V
nước	N
nóng	A
,	CH
tôi	P
pha	V
rượu	N
táo	V
nóng	A
.	CH

Hàng	N
trăm	M
người	N
đến	V
dùng	V
tiệc	N
tự	P
chọn	V
ở	E
chỗ	N
mẹ	N
những	L
ngày	N
Giáng_sinh	V
.	CH

Năm	Np
nào	P
cũng	R
vậy	P
hoặc	Cc
có_vẻ	V
như_vậy	C
.	CH

Tôi	P
chưa	R
bao_giờ	N
thực_sự	A
cảm_thấy	V
mệt_mỏi	A
vì	E
nó	P
.	CH

Tôi	P
đã	R
có_thể	V
chống	V
lại	R
cảm_giác	V
đó	P
trong	E
nhiều	A
năm	N
qua	V
.	CH

Những	L
năm	N
gần	A
đây	P
tôi	P
qua_lại	V
sân_bay	N
Tân_Sơn_Nhất	N
thường_xuyên	R
.	CH

Trường	Np
tôi	P
từng	P
nghiêm_cấm	A
sử_dụng	N
điện_thoại	N
trong	E
lớp	N
.	CH

Học_sinh	V
ngày_nay	N
có_thể	V
dễ_dàng	A
tiếp_cận	V
bài_học	Nc
và	Cc
phương_pháp	N
giải	N
bài_tập	Nc
.	CH

Điện_thoại	N
thông_minh	V
là	V
công_cụ	N
không_thể	R
đảo_ngược	N
trong	E
cuộc_sống	Nc
.	CH
